4,4,4,4,4,4,4,4,4,4,4,4,4,4,4,4,4,4,4,4
4,4,1,1,1,1,1,1,1,1,1,1,1,1,1,1,1,1,4,4
4,4,1,1,1,1,1,1,1,1,1,1,1,1,1,1,1,1,4,4
4,4,1,1,1,1,1,1,11,1,12,1,1,1,1,1,1,1,4,4
4,4,1,1,1,1,1,1,1,1,1,1,1,1,1,1,1,1,4,4
4,4,1,1,1,1,1,1,1,1,1,1,1,1,1,1,1,1,4,4
4,4,1,1,1,1,1,1,1,1,1,1,1,1,1,1,1,1,4,4
4,4,1,1,1,10,1,1,1,1,1,1,1,10,1,1,1,1,4,4
4,4,1,1,1,1,1,1,1,1,1,1,1,1,1,1,1,1,4,4
4,4,1,1,1,10,1,1,1,1,1,1,1,10,1,1,1,1,4,4
4,4,1,1,1,1,1,1,1,1,1,1,1,1,1,1,1,1,4,4
4,4,1,1,1,10,1,1,1,1,1,1,1,10,1,1,1,1,4,4
4,4,1,1,1,1,1,1,1,1,1,1,1,1,1,1,1,1,4,4
4,1,1,1,1,10,1,1,1,1,1,1,1,10,1,1,1,1,4,4
4,1,1,1,1,1,1,1,1,1,1,1,1,1,1,1,1,1,4,4
4,1,5,6,1,1,1,1,1,1,1,1,1,1,1,1,1,1,4,4
4,1,7,8,1,1,1,1,1,1,1,1,1,1,1,1,2,2,4,4
4,1,1,1,1,1,1,1,1,1,1,1,1,1,1,1,4,4,4,4
4,4,4,4,4,1,1,1,1,1,1,1,1,1,1,4,4,4,4,4
4,4,4,4,4,1,1,1,1,0,1,1,1,1,1,4,4,4,4,4
