4,4,4,4,4,4,4,4,4,4,4,4,4,4,4,4,4,4,4,4,
4,4,1,1,1,1,1,1,1,1,1,1,1,1,1,1,1,1,4,4,
4,4,1,1,1,1,1,1,1,1,11,1,1,1,1,1,1,1,4,4,
4,4,1,1,1,10,1,1,1,1,1,1,1,1,10,1,1,1,4,4,
4,4,1,1,1,1,1,1,1,1,1,1,1,1,1,1,1,1,4,4,
4,4,1,1,1,10,1,1,1,1,1,1,1,1,10,